# NetHack 3.6 purgatory.des $NHDT-Date: 1665083916 2022/10/06 19:18:36 $  $NHDT-Branch: master $:$NHDT-Revision: 1.9 $
#	Copyright (c) 2022 by Keith Simpson
# NetHack may be freely redistributed.  See license for details.
#
#	Purgaotory - the player must defeat Lucifer in the
#	Sanctum to gain access to Purgatory, which is the
#	only way out of Gehennom.
#
MAZE: "purgatory-1",' '
FLAGS: noteleport,hardfloor,solidify,shortsighted,nommap
MESSAGE: "You stand atop a craggly mountain."
MESSAGE: "A deep chasm lies between you and an ancient palace."
GEOMETRY:left,center
#         1         2         3         4         5         6         7    7
#123456789012345678901234567890123456789012345678901234567890123456789012345
MAP
.T..AAAA.tt....AAAAAAAAAAAAAAAAAAAAAAAAAAAAAAAAAAAAAAAAAAAAAAAAAAAAAAAAAAAAA
-------------....AAAAAAAAAAAAAAAAAAAAAAAAAAAAAAAAAAAAAAAAAAAAAAAAAAAAAAAAAAA
|.|.........|.TT..AAAAAAAAAAAAAAAAAAAAAAAAAAAAAAAAAAAAAAAAAAAAAAAAAAAAAAAAAA
|.+.........|..TTT..AAAAAAAAAAAAAAAAAAAAAAAAAAAAAAAAAAAAAAAAAAAAAAAAAAAAAAAA
|--.........|..........AAAAAAAAAAAAAAAAAAAAAAAAAAAAAAAAAAA...AAAAAAAAAAA....
|.|...T.....|--------....AAAAAAAAAAAAAAAAAAAAAAAAAAAAAA.......AAAAAAAA...T..
|.+..T......|}}}}}}}|.T....AAAAAAAAAA...AAAAAAAAAAAAAA...AAAA..AAAAAA.TT....
|--.T.......|}......----------AAAAAA.....AAAAAAAAAAA...AAAAAAA..AAAA...--...
|.|.........|}...............+.AAAAAA.....AAAAAAAA....AAAAAAAA...AA...--....
|.S.\.......|}...............+..AAAAAA...AAAAAA......AAAAAAAAAA.......|.....
|.|.........|}...............+....AAAAAAAAAAAA..T..AAAAAAAAAAAAA......--....
|--.T.......|}......----------AA...AAAAAAAAAA.....AAAAAAAAAAAAAAAAAA...--...
|.+..T......|}}}}}}}|......AAAAAAA....AAAA....AAAAAAAAAAAAAAAAAAAAAAA......T
|.|...T.....|--------..T.AAAAAAAAAAA...AA...AAAAAAAAAAAAAAAAAAAAAAAAAA..TT..
|--.........|.t...TT...AAAAAAAAAAAAAAA....AAAAAAAAAAAAAAAAAAAAAAAAAAAAAAT...
|.+.........|tt.....AAAAAAAAAAAAAAAAAAAA..AAAAAAAAAAAAAAAAAAAAAAAAAAAAAAAAAA
|.|.........|...T.AAAAAAAAAAAAAAAAAAAAAAAAAAAAAAAAAAAAAAAAAAAAAAAAAAAAAAAAAA
-------------....AAAAAAAAAAAAAAAAAAAAAAAAAAAAAAAAAAAAAAAAAAAAAAAAAAAAAAAAAAA
.AA.T.AA...A...AAAAAAAAAAAAAAAAAAAAAAAAAAAAAAAAAAAAAAAAAAAAAAAAAAAAAAAAAAAAA
AAAAAAAAAAAAAAAAAAAAAAAAAAAAAAAAAAAAAAAAAAAAAAAAAAAAAAAAAAAAAAAAAAAAAAAAAAAA
ENDMAP

# Random monsters
$monster = monster: { 'D','J' }
SHUFFLE: $monster

# Player monster locations (one will always be blank)
$place = { (16,15),(31,09),(47,10),(73,14) }
SHUFFLE: $place

# Palace guard locations (one will always be blank)
$palace = { (01,03),(01,06),(01,12),(01,15),
            (05,05),(05,13),(10,03),(10,15) }
SHUFFLE: $palace

REGION:(00,00,75,19),lit,"ordinary"
REGION:(01,02,11,16),lit,"throne",unfilled
TELEPORT_REGION:(72,08,74,10),(00,00,00,00)
# Exit portal to sokoban
PORTAL:(01,09,01,09),(0,0,0,0), "castle"
# Stairs
STAIR:(73,09),down

# Entrances to throne room
DRAWBRIDGE:(13,08),west,closed
DRAWBRIDGE:(13,10),west,closed

# Various doors
DOOR:closed,(02,03)
DOOR:closed,(02,06)
DOOR:locked,(02,09)
DOOR:closed,(02,12)
DOOR:closed,(02,15)
DOOR:locked,(29,08)
DOOR:locked,(29,09)
DOOR:locked,(29,10)

# Decoration
FOUNTAIN:(06,03)
FOUNTAIN:(06,15)

# Monsters
MONSTER:('A',"Archangel"),(04,09),"Saint Michael",asleep,hostile

MONSTER:('A',"Angel"),$palace[0],asleep,hostile
MONSTER:('A',"Angel"),$palace[1],asleep,hostile
MONSTER:('D',"celestial dragon"),$palace[2],asleep,hostile
MONSTER:'A',$palace[3],asleep,hostile
MONSTER:'D',$palace[4],asleep,hostile
MONSTER:'H',$palace[5],asleep,hostile
MONSTER:'J',$palace[6],asleep,hostile

MONSTER:('@',"valkyrie"),$place[0]
MONSTER:('@',"priest"),$place[1]
MONSTER:('@',"ranger"),$place[2]

MONSTER:('D',"celestial dragon"),(20,09),hostile
MONSTER:(';',"kraken"),(14,06),hostile
MONSTER:(';',"kraken"),(18,06),hostile
MONSTER:(';',"kraken"),(14,12),hostile
MONSTER:(';',"kraken"),(18,12),hostile

MONSTER:'C',(38,07),hostile {
  OBJECT:(')',"elven bow"),uncursed
  OBJECT:(')',"elven arrow"),uncursed,quantity:100
}

MONSTER:(' ',"ghost"),random
MONSTER:(' ',"ghost"),random
MONSTER:(' ',"ghost"),random
MONSTER:(' ',"ghost"),random
MONSTER:(' ',"spectre"),random
MONSTER:(' ',"spectre"),random
MONSTER:(' ',"spectre"),random
MONSTER:(' ',"spectre"),random
MONSTER:(' ',"spectre"),random
MONSTER:'e',random
MONSTER:'e',random
MONSTER:'e',random
MONSTER:'e',random
MONSTER:('H',"storm giant"),(50,15),hostile
MONSTER:('H',"storm giant"),(58,04),hostile
MONSTER:$monster[0],random
MONSTER:$monster[1],random
MONSTER:$monster[0],random
MONSTER:$monster[1],random

# Loot
OBJECT:('(',"crystal chest"),(01,02)
OBJECT:('(',"crystal chest"),(01,05)
OBJECT:('(',"crystal chest"),(01,13)
OBJECT:('(',"crystal chest"),(01,16)
OBJECT:('/',"opening"),(13,14)
OBJECT:('%',"egg"), (02,00), montype:"celestial dragon"
[50%]: OBJECT: ('%',"egg"), (02,00), montype:"celestial dragon"

# Walls in the palace are non diggable and non passable
NON_DIGGABLE:(00,01,12,17)
NON_DIGGABLE:(12,05,29,13)
NON_PASSWALL:(00,01,12,17)
NON_PASSWALL:(12,05,29,13)


MAZE: "purgatory-2",' '
FLAGS: noteleport,hardfloor,solidify,shortsighted,nommap

GEOMETRY:left,center
#         1         2         3         4         5         6         7    7
#123456789012345678901234567890123456789012345678901234567890123456789012345
MAP
TT..PPPPP..TTTTTTTTTTTTTTTTT...TTTTTTTTTTTTTTTTT...TTT.TTTT.----------------
T..T.PPPPP...TTTTTT..........TTTTTTTTTTT....................|..............|
......PPP.......................................TTTTT......T|..............|
TTT....PPP......TTT.....................P....TTTT.........TT|..............|
..TT..PPPP....TTTT......TTTT...........PPP...............TT.......---------|
.......PPPP...............TT............P................TT.......|........|
..TT....PPPP......TT..............TTT........TT......T....T.......+........|
.TTT....PPPPP.....T...............TTT.......TTT...................|........|
.........PPPP..T..TPPPPPPPP........TT.........TTT......T..........+........|
....T..T..PPP.TT.PPPPPPT.PPPPPP....T..............................|........|
...........PPPPPPPPP........PPPPPPPP.......TT.....TT..............---------|
..TT......PPPPPPP..............PPPPPPPPP.TTT.......TT.......|..............|
T..TTT..PPPPP.........TTTTT.......PPPPPPPP.............TT...|..............|
T......PPPPP.TT.....TTT...TTT.......T.PPPPPP...........TTT..|..............|
.......PPPP..T.....TT.......TT.....TTT...PPPPPPPPP......T...----------------
......PPPP........TT..........................PPPPPPP.........ttt........t..
.....TTPPPP.......TT.................TTTTT........PPPPP..............TTT....
......T.PPPP..TT...TT.......TT.....TTTTT............PPPP..............T....T
T........PPPPTT.....TTT...TTT........TTTT....TTT......PPPPP...............TT
T..TTTT...PPP...T.....TTTTT.............................PPPPPP....TTTTTTTTTT
ENDMAP

# Random monsters
$monster = monster: { 'C','D','J','n' }
SHUFFLE: $monster

$river = { (07,01),(11,09),(09,13),(22,08),
           (28,09),(34,11),(42,14),(56,18) }
SHUFFLE: $river

# Player monster locations (one will always be blank)
$place = { (02,09),(21,02),(15,15),
           (40,07),(55,05),(63,12),(32,17) }
SHUFFLE: $place

REGION:(00,00,75,19),lit,"ordinary"
TELEPORT_REGION:(02,16,03,18),(00,00,00,00)
BRANCH:(01,16,01,16),(0,0,0,0)
# Stairs
STAIR:(73,07),up
ENGRAVING:(72,07),burn,"To the Mountain of Purgatory"

# Entrances to main room
DOOR:locked,(66,06)
DOOR:locked,(66,08)

# Functional decor
FOUNTAIN:(22,16)
FOUNTAIN:(24,14)
FOUNTAIN:(26,16)
FORGE:(72,02)
FORGE:(72,12)

# Monsters
MONSTER:('@',"barbarian"),$place[0]
MONSTER:('@',"knight"),$place[1]
MONSTER:('@',"wizard"),$place[2]
MONSTER:('@',"healer"),$place[3]
MONSTER:('@',"infidel"),$place[4]
MONSTER:('@',"rogue"),$place[5]

MONSTER:(' ',"spectre"),(01,09)
MONSTER:(' ',"spectre"),(03,09)
MONSTER:(' ',"spectre"),(02,08)
MONSTER:(' ',"spectre"),(20,02)
MONSTER:(' ',"spectre"),(22,02)
MONSTER:(' ',"spectre"),(21,03)
MONSTER:(' ',"spectre"),(14,15)
MONSTER:(' ',"spectre"),(16,15)
MONSTER:(' ',"spectre"),(16,16)
MONSTER:(' ',"spectre"),(40,06)
MONSTER:(' ',"spectre"),(40,08)
MONSTER:(' ',"spectre"),(39,07)
MONSTER:(' ',"spectre"),(55,04)
MONSTER:(' ',"spectre"),(56,05)
MONSTER:(' ',"spectre"),(56,06)
MONSTER:(' ',"spectre"),(63,11)
MONSTER:(' ',"spectre"),(62,12)
MONSTER:(' ',"spectre"),(64,12)
MONSTER:(' ',"spectre"),(31,17)
MONSTER:(' ',"spectre"),(33,17)
MONSTER:(' ',"spectre"),(33,18)

MONSTER:('n',"water nymph"),(40,04)
MONSTER:('J',"vorpal jabberwock"),(69,07)

MONSTER:(' ',"ghost"),random
MONSTER:(' ',"ghost"),random
MONSTER:(' ',"ghost"),random
MONSTER:(' ',"ghost"),random
MONSTER:(' ',"ghost"),random
MONSTER:(' ',"ghost"),random
MONSTER:(' ',"ghost"),random
MONSTER:(' ',"ghost"),random
MONSTER:(' ',"ghost"),random
MONSTER:(' ',"ghost"),random
MONSTER:(' ',"ghost"),random
MONSTER:(' ',"ghost"),random
MONSTER:(' ',"ghost"),random
MONSTER:(';',"kraken"),$river[0]
MONSTER:(';',"kraken"),$river[1]
MONSTER:(';',"giant eel"),$river[2]
MONSTER:(';',"giant eel"),$river[3]
MONSTER:(';',"electric eel"),$river[4]
MONSTER:(';',"electric eel"),$river[5]
MONSTER:(';',"shark"),$river[6]
MONSTER:(';',"shark"),$river[7]
MONSTER:'e',random
MONSTER:'e',random
MONSTER:'e',random
MONSTER:'e',random
MONSTER:'e',random
MONSTER:'D',random
MONSTER:'D',random
MONSTER:$monster[0],random
MONSTER:$monster[0],random
MONSTER:$monster[3],random
MONSTER:$monster[3],random
MONSTER:$monster[0],random
MONSTER:$monster[1],random
MONSTER:$monster[2],random
MONSTER:$monster[3],random
MONSTER:$monster[0],random
MONSTER:$monster[1],random
MONSTER:$monster[2],random
MONSTER:$monster[3],random
