# NetHack 3.6 purgatory.des $NHDT-Date: 1665083916 2022/10/06 19:18:36 $  $NHDT-Branch: master $:$NHDT-Revision: 1.9 $
#	Copyright (c) 2022 by Keith Simpson
# NetHack may be freely redistributed.  See license for details.
#
#	Purgaotory - the player must defeat Lucifer in the
#	Sanctum to gain access to Purgatory, which is the
#	only way out of Gehennom.
#
MAZE: "purgatory-1",' '
FLAGS: noteleport,hardfloor,solidify,shortsighted

GEOMETRY:left,center
#         1         2         3         4         5         6         7    7
#123456789012345678901234567890123456789012345678901234567890123456789012345
MAP
.T..AAAA.TT....AAAAAAAAAAAAAAAAAAAAAAAAAAAAAAAAAAAAAAAAAAAAAAAAAAAAAAAAAAAAA
-------------....AAAAAAAAAAAAAAAAAAAAAAAAAAAAAAAAAAAAAAAAAAAAAAAAAAAAAAAAAAA
|.|.........|.TT..AAAAAAAAAAAAAAAAAAAAAAAAAAAAAAAAAAAAAAAAAAAAAAAAAAAAAAAAAA
|.+.........|..TTT..AAAAAAAAAAAAAAAAAAAAAAAAAAAAAAAAAAAAAAAAAAAAAAAAAAAAAAAA
|.|.........|..........AAAAAAAAAAAAAAAAAAAAAAAAAAAAAAAAAAA...AAAAAAAAAAA....
|--.........|--------....AAAAAAAAAAAAAAAAAAAAAAAAAAAAAA.......AAAAAAAA...T..
|.+.........|}......|.T....AAAAAAAAAA...AAAAAAAAAAAAAA...AAAA..AAAAAA.TT....
|.|.........|}......----------AAAAAA.....AAAAAAAAAAA...AAAAAAA..AAAA...|-...
|--.........|}...............+.AAAAAA.....AAAAAAAA....AAAAAAAA...AA...--....
|.S.\.......|}...............+..AAAAAA...AAAAAA......AAAAAAAAAA.......|.....
|--.........|}...............+....AAAAAAAAAAAA..T..AAAAAAAAAAAAA......--....
|.|.........|}......----------AA...AAAAAAAAAA.....AAAAAAAAAAAAAAAAAA...|-...
|.+.........|}......|......AAAAAAA....AAAA....AAAAAAAAAAAAAAAAAAAAAAA......T
|--.........|--------..T.AAAAAAAAAAA...AA...AAAAAAAAAAAAAAAAAAAAAAAAAA..TT..
|.|.........|.t...TT...AAAAAAAAAAAAAAA....AAAAAAAAAAAAAAAAAAAAAAAAAAAAAAT...
|.+.........|tt.....AAAAAAAAAAAAAAAAAAAA..AAAAAAAAAAAAAAAAAAAAAAAAAAAAAAAAAA
|.|.........|...T.AAAAAAAAAAAAAAAAAAAAAAAAAAAAAAAAAAAAAAAAAAAAAAAAAAAAAAAAAA
-------------....AAAAAAAAAAAAAAAAAAAAAAAAAAAAAAAAAAAAAAAAAAAAAAAAAAAAAAAAAAA
.AA.T.AA...A...AAAAAAAAAAAAAAAAAAAAAAAAAAAAAAAAAAAAAAAAAAAAAAAAAAAAAAAAAAAAA
AAAAAAAAAAAAAAAAAAAAAAAAAAAAAAAAAAAAAAAAAAAAAAAAAAAAAAAAAAAAAAAAAAAAAAAAAAAA
ENDMAP
REGION:(00,00,75,19),lit,"ordinary"
REGION:(01,02,11,16),lit,"throne",unfilled
TELEPORT_REGION:(72,08,74,10),(00,00,00,00)
# Portal to starting quest level
PORTAL:(01,09,01,09),(0,0,0,0), "soko4"
# Stairs
STAIR:(73,09),down

DRAWBRIDGE:(13,08),west,closed
DRAWBRIDGE:(13,10),west,closed

DOOR:closed,(02,03)
DOOR:closed,(02,06)
DOOR:locked,(02,09)
DOOR:closed,(02,12)
DOOR:closed,(02,15)
DOOR:locked,(29,08)
DOOR:locked,(29,09)
DOOR:locked,(29,10)

FOUNTAIN:(06,04)
FOUNTAIN:(06,14)



MAZE: "purgatory-2",' '
FLAGS: noteleport,hardfloor,solidify,shortsighted

GEOMETRY:left,center
#         1         2         3         4         5         6         7    7
#123456789012345678901234567890123456789012345678901234567890123456789012345
MAP
TT..PPPPP..TTTTTTTTTTTTTTTTT...TTTTTTTTTTTTTTTTT...TTT.TTTT.----------------
T..T.PPPPP...TTTTTT..........TTTTTTTTTTT....................|..............|
......PPP.......................................TTTTT.......|..............|
TTT....PPP......TTT..........................TTTT...........|..............|
..TT..PPPP....TTTT......TTTT.............................T........---------|
.......PPPP...............TT......................................|........|
..TT....PPPP......TT..............TTT........TT......T............+........|
.TTT....PPPPP.....................TTT.......TTT...................|........|
.........PPPP..T...PPPPPPPP........TT.........TTT......T..........+........|
....T..T..PPP.TT.PPPPPPT.PPPPPP...................................|........|
...........PPPPPPPPP........PPPPPPPP.......TT.....................---------|
..TT......PPPPPPP..............PPPPPPPPP.T..................|..............|
T..TTT..PPPPP.........TTTTT.......PPPPPPPP.............TT...|..............|
T......PPPPP.TT.....TTT...TTT.......T.PPPPPP...........TTT..|..............|
.......PPPP..T.....TT.......TT.....TTT...PPPPPPPPP..........----------------
......PPPP........TT..........................PPPPPPP.........ttt........t..
.....TTPPPP.......TT.................TTTTT........PPPPP..............TTT....
......T.PPPP..TT...TT.......TT.....TTTTT............PPPP..............T....T
T........PPPPTT.....TTT...TTT........TTTT....TTT......PPPPP...............TT
T..TTTT...PPP...T.....TTTTT.............................PPPPPP....TTTTTTTTTT
ENDMAP
REGION:(00,00,75,19),lit,"ordinary"
TELEPORT_REGION:(02,16,03,18),(00,00,00,00)
BRANCH:(01,16,01,16),(0,0,0,0)
# Stairs
STAIR:(73,07),up

DOOR:locked,(66,06)
DOOR:locked,(66,08)

FOUNTAIN:(22,16)
FOUNTAIN:(24,14)
FOUNTAIN:(26,16)

FORGE:(72,02)
FORGE:(72,12)
