# NetHack 3.6  vecna.des  $NHDT-Date: 1616171562 2020/03/19 12:32:42 $  $NHDT-Branch: master $:$NHDT-Revision: 1.9 $
#       Copyright (c) 2021 by Keith Simpson
# NetHack may be freely redistributed.  See license for details.
#
#       Vecna's graveyard - the player must discover
#       which one of four mausoleums to enter to progress
#
MAZE: "vecna-1",' '
FLAGS: noteleport,hardfloor,shortsighted,nommap,graveyard
GEOMETRY:left,center
#         1         2         3         4         5         6         7    7
#123456789012345678901234567890123456789012345678901234567890123456789012345
MAP
tttttttttttttttttttttttttttttttttttttttttttttttttttttttttttttttttttttttttttt
t.................ttttt......ttttttt....tttttttt......ttttttttt............t
t.--------..........tt.........ttttt.....ttt.....tt......ttt..t...--------.t
t.|......S.ttt.....t.....tt.....................................t.S......|.t
t.|......|..tt.......t.t.......ttt..ttt...........tt......tt....tt|......|.t
t.|...----.......tt.............tt.................ttt............----...|.t
t.|...|...t........t....t.......tttttt.tttttt..............t...tt....|...|.t
t.|...|....t...tt.....t........tt...........tt............t..........|...|.t
t.-----......t....tt.......tt.tt.............tt.ttt..........t......t-----.t
...t..................tttt..ttt...............t.............t..ttt..........
...........t..tt............t...................ttt.........................
t.............................t...............t.............t...ttttt......t
t.-----.....................tttt.............tt....t............tt...-----.t
t.|...|..tt.....tttt...........tt...........ttttt....................|...|..
t.|...|......t.................ttttttt.tttttt......tt....t....tt.....|...|..
t.|...----...........t......................t.....................----...|..
t.|......|tt.....tt.....ttttt.........ttt....tt.......ttttt.......|......|.t
t.|......S...t...tt......ttttt................ttt.....ttt.........S......|.t
t.--------t.........................ttt...........................--------.t
t...............ttt........ttttt..tt.....tttt....ttttt....ttt..............t
tttttttttttttttttttttttttttttttttttttttttttttttttttttttttttttttttttttttttttt
ENDMAP
$stairs = { (04,06),(04,14),(71,06),(71,14) }
$liches = { (03,07),(03,13),(72,07),(72,13) }
SHUFFLE: $stairs
SHUFFLE: $liches
TELEPORT_REGION:(33,07,43,13),(00,00,00,00)
REGION:(00,00,75,20),unlit,"ordinary"
REGION:(13,03,27,17),unlit,"morgue",filled
REGION:(49,03,62,17),unlit,"morgue",filled
REGION:(03,03,05,05),unlit,"morgue",filled
REGION:(03,15,05,17),unlit,"morgue",filled
REGION:(70,03,72,05),unlit,"morgue",filled
REGION:(70,15,72,17),unlit,"morgue",filled

# Portal arrival point
BRANCH:(38,10,38,10),(0,0,0,0)

# Stairs (random)
STAIR:$stairs[0],down

# 'Fake' stairs
MONSTER:('m',"giant mimic"),$stairs[1],m_feature "staircase down"
MONSTER:('m',"giant mimic"),$stairs[2],m_feature "staircase down"
MONSTER:('m',"giant mimic"),$stairs[3],m_feature "staircase down"

# Liches
MONSTER:('L',"lich"),$liches[0],asleep
MONSTER:('L',"lich"),$liches[1],asleep
MONSTER:('L',"demilich"),$liches[2],asleep
MONSTER:('L',"demilich"),$liches[3],asleep

# Secret Doors
DOOR:locked,(09,03)
DOOR:locked,(09,17)
DOOR:locked,(66,03)
DOOR:locked,(66,17)

# Random monsters
MONSTER:'V',random
MONSTER:'V',random
MONSTER:'V',random
MONSTER:'V',random
MONSTER:'V',random
MONSTER:'V',random
MONSTER:'Z',random
MONSTER:'Z',random
MONSTER:'Z',random
MONSTER:'Z',random
MONSTER:'Z',random
MONSTER:'Z',random
MONSTER:'Z',random
MONSTER:'Z',random
MONSTER:'M',random
MONSTER:'M',random
MONSTER:'M',random
MONSTER:'M',random
MONSTER:'M',random
MONSTER:'M',random
MONSTER:'M',random
MONSTER:'M',random
MONSTER:' ',random
MONSTER:' ',random
MONSTER:' ',random
MONSTER:' ',random

# Random traps
TRAP:"ice",random
TRAP:"ice",random
TRAP:random, random
TRAP:random, random
TRAP:random, random
TRAP:random, random
TRAP:random, random
TRAP:random, random
TRAP:random, random
TRAP:random, random
TRAP:random, random
TRAP:random, random

# None shall pass
NON_DIGGABLE:(02,02,09,08)
NON_DIGGABLE:(66,02,73,08)
NON_DIGGABLE:(02,12,09,18)
NON_DIGGABLE:(66,12,73,18)
NON_PASSWALL:(00,00,75,20)


#
# The Stronghold of Kas
#
MAZE: "vecna-2",' '
FLAGS: noteleport,hardfloor,shortsighted,nommap
GEOMETRY:left,center
#         1         2         3         4         5         6         7    7
#123456789012345678901234567890123456789012345678901234567890123456789012345
MAP
LLLLLLLLLLLLLLLLLLLLLLLLLLLLLLLLLLLLLLLLLLLLLLLLLLLLLLLLLLLLLLLLLLLLLLLLLLLL
LLLLLLLLLLLLLLLLLLLLLLLLLLLLLLLLLLLLLLLLLLLLLLLLLLLLLLLLLLLLLLLLLLLLLLLLLLLL
LLLLLLLLL--FF----FFF----FF--LLLLLLLL--F--LLLLLLLLLLLLLLLLLLLLLLLLLLLLLLLLLLL
LLLLLLLL-|.................|-LLLLLLL|...|LLLLLLLLLLLLLLLLLLLLLLLLLLLLLLLLLLL
LLLLLLL-|...................|-LLLLLL|...|LLLLLLLLLLLLLLLLLLLL----FF----LLLLL
LLLLLL-|...---.........---...|-LLLLL|...|LLLLLLLLLLLLLLLLLLLL|........|LLLLL
LL----|....- -.........- -....|------...-------LLLLLLLLLLL----...--...----LL
LL|...F....---.........---....S..|............|LLLLLLLLLLL|......--......|-L
LL|-FFF.......................|..|............|LLLL---FF---...............|L
LLF...........................|..|..--------..|LLLL|......................FL
LLF...........................|..|.........|......L|......................FL
LLF...........................|..|.........|..|LLLL|......................FL
LL|-FFF.......................|..--------..|FF|LLLL---FF---...............|L
LL|...F....---.........---....|............|..|LLLLLLLLLLL|......--......|-L
LL----|....- -.........- -....|------...----FF-LLLLLLLLLLL----...--...----LL
LLLLLL-|...---.........---...|-LLLLL|...|LLLLLLLLLLLLLLLLLLLL|........|LLLLL
LLLLLLL-|...................|-LLLLLL|...|LLLLLLLLLLLLLLLLLLLL----FF----LLLLL
LLLLLLLL-|.................|-LLLLLLL|...|LLLLLLLLLLLLLLLLLLLLLLLLLLLLLLLLLLL
LLLLLLLLL--FF----FFF----FF--LLLLLLLL--F--LLLLLLLLLLLLLLLLLLLLLLLLLLLLLLLLLLL
LLLLLLLLLLLLLLLLLLLLLLLLLLLLLLLLLLLLLLLLLLLLLLLLLLLLLLLLLLLLLLLLLLLLLLLLLLLL
LLLLLLLLLLLLLLLLLLLLLLLLLLLLLLLLLLLLLLLLLLLLLLLLLLLLLLLLLLLLLLLLLLLLLLLLLLLL
ENDMAP
TELEPORT_REGION:(03,09,07,11),(00,00,00,00)
REGION:(00,00,75,20),unlit,"ordinary"
STAIR:(03,10),up
STAIR:(72,10),down

# Drawbridges
DRAWBRIDGE:(50,10),east,closed

# Secret Doors
DOOR:locked,(30,07)

# Monsters
MONSTER:(':',"salamander"),(48,09),hostile
MONSTER:(':',"salamander"),(48,11),hostile
MONSTER:(':',"salamander"),(51,03),hostile
MONSTER:(':',"salamander"),(51,17),hostile
MONSTER:('&',"marilith"),(04,07),awake {
  OBJECT:(')',"orcish bow"),uncursed
  OBJECT:(')',"orcish arrow"),uncursed,quantity:50
}
MONSTER:('&',"marilith"),(04,13),awake {
  OBJECT:(')',"orcish bow"),uncursed
  OBJECT:(')',"orcish arrow"),uncursed,quantity:50
}
MONSTER:('&',"marilith"),(44,13),awake {
  OBJECT:(')',"orcish bow"),uncursed
  OBJECT:(')',"orcish arrow"),uncursed,quantity:100
}
MONSTER:('e',"beholder"),(18,04),awake
MONSTER:('e',"beholder"),(18,16),awake
MONSTER:('L',"master lich"),(38,03),asleep
MONSTER:('L',"master lich"),(38,04),asleep
MONSTER:('L',"master lich"),(38,16),asleep
MONSTER:('L',"master lich"),(38,17),asleep
MONSTER:('&',"weredemon"),(54,10),hostile
MONSTER:('V',"vampire royal"),(55,09),hostile
MONSTER:('V',"vampire mage"),(55,11),hostile
MONSTER:('V',"vampire royal"),(63,07),hostile
MONSTER:('V',"vampire royal"),(63,13),hostile
MONSTER:('&',"balrog"),(66,10),hostile
MONSTER:('V',"vampire royal"),(65,09),hostile
MONSTER:('V',"vampire royal"),(65,11),hostile
MONSTER:('L',"demilich"),(72,07),hostile
MONSTER:('L',"demilich"),(72,13),hostile
# Kas
MONSTER:('V',"Kas"),(72,10),asleep

# Kas' loot
OBJECT:('(',"iron safe"),(72,09)
OBJECT:('(',"chest"),(72,11)

# Random monsters
MONSTER:'V',(09,05)
MONSTER:'V',(10,08)
MONSTER:'V',(26,06)
MONSTER:'V',(27,09)
MONSTER:'V',(15,11)
MONSTER:'V',(23,10)
MONSTER:'Z',(14,03)
MONSTER:'Z',(20,17)
MONSTER:'Z',(31,08)
MONSTER:'Z',(44,10)
MONSTER:('Z',"revenant"),(18,10)
MONSTER:('Z',"revenant"),(17,11)
MONSTER:('Z',"revenant"),(13,12)
MONSTER:('Z',"revenant"),(28,14)
MONSTER:'M',(17,07)
MONSTER:'M',(17,13)
MONSTER:'M',(36,10)
MONSTER:'M',(34,08)
MONSTER:'M',(09,16)
MONSTER:'M',(07,07)
MONSTER:'M',(12,12)
MONSTER:' ',random
MONSTER:' ',random
MONSTER:' ',random
MONSTER:' ',random

# Random traps
TRAP:"ice",random
TRAP:"ice",random
TRAP:random, random
TRAP:random, random
TRAP:random, random
TRAP:random, random
TRAP:random, random
TRAP:random, random
TRAP:random, random
TRAP:random, random
TRAP:random, random
TRAP:random, random
TRAP:random, random
TRAP:random, random
TRAP:random, random

# None shall pass
NON_DIGGABLE:(00,00,75,20)
NON_PASSWALL:(00,00,75,20)


#
# Vecna's domain
#
MAZE: "vecna-3",' '
FLAGS: noteleport,hardfloor,shortsighted,nommap
GEOMETRY:left,center
#         1         2         3         4         5         6         7    7
#123456789012345678901234567890123456789012345678901234567890123456789012345
MAP
tt....LLLLL.tttttLLLLLLLLLLLLLLLLLLLLLL......t..LLLLLLLLLLLL..tttt......LLLL
...LLLLLL--S----------------LLLLLLLLLL.ttt.....LLLLLLLLttt.........tt.....LL
.LLLLL----.................----LLLLLL...tt....LLLL................ttt.....LL
LLL----.....------------......----LLL.ttt....LLLL...................tt.....L
LL--........|.....---------......--LL......LLLLL......L.....................
L||....------.....|.......------..||L....LLLLLL......LLLttt................t
L|---..|..S.......S.......|....|...|LL.LLLLLLL........Lttt.................L
L|..|..--.|.......|.......|---.|...|LLLLLLLLLL......tttt............tt.....L
L|..|...--|.......|.......S....|...|LLLLLLLLL....................tttttt....L
L|..--....--S-----|.......S....|...|LLLLLLL......................ttt........
L|...--...........|.......------...|LLLLLL..................................
L||...----........|.......|.......||LLL..................-----........LLL...
LL--.....------------------......--LLL...tttt...........||...|......LLL.....
LLL----.......................----LLL...ttt.............|....S.............L
.LLLLL----.................----LLLLLLL....tttt.....tttt.||...|.............t
...LLLLLL-------------------LLLLLLLLLL..............ttt..-----.............t
......LLLLLLLLLLLLLLLLLLLLLLLLLLLLLLLL......LLLLLLLL.....ttt..........tt....
L.......t.....LLLtttLL.........LLLLLLLL...LLLLLLLLLLLLLL........tt....t.....
L......ttt.................LL....LLLLLLLLLLLL....LLLLLLLLLL......tt.L......t
.ttt...........tt.........LL........LLLLLLL.............LLLLLL......LL.....t
..tttttt......ttt.....LLLLt..........ttt....................LLLLL...LLLLLLtt
ENDMAP
TELEPORT_REGION:(01,01,75,20),(01,01,70,19)
REGION:(00,00,75,20),unlit,"ordinary"
REGION:(58,12,61,14),unlit,"morgue",filled
STAIR:(73,18),up

# Doors and drawbridges
DRAWBRIDGE:(00,08),east,closed
DOOR:locked,(61,13)
DOOR:locked,(10,06)
DOOR:locked,(12,09)
DOOR:locked,(18,06)
DOOR:locked,(26,08)
DOOR:locked,(26,09)

# chance of a secret way into the lair
IF [50%] {
  DOOR:locked,(11,01)
} ELSE {
  TERRAIN: (11,01), '-'
}

# chance for a forge
IF [25%] {
  FORGE:(66,06)
}

# Various monsters
MONSTER:(':',"salamander"),(03,01),hostile
MONSTER:(':',"salamander"),(05,15),hostile
MONSTER:(':',"salamander"),(44,05),hostile
MONSTER:(':',"salamander"),(46,17),hostile
MONSTER:('U',"shambling horror"),(03,08),hostile
MONSTER:('h',"alhoon"),(57,13),asleep
MONSTER:('L',"demilich"),(08,06),asleep
MONSTER:('H',"elder minotaur"),(11,02),hostile
MONSTER:('z',"skeleton warrior"),(17,13),hostile
MONSTER:('z',"skeleton warrior"),(19,14),hostile
# Liches
MONSTER:('L',"master lich"),(39,02),asleep
MONSTER:('L',"master lich"),(14,19),asleep
MONSTER:('L',"arch-lich"),(22,08),asleep
MONSTER:('L',"lich"),(21,07),asleep
MONSTER:('L',"lich"),(21,09),asleep
MONSTER:('L',"lich"),(23,07),asleep
MONSTER:('L',"lich"),(23,09),asleep
# Vecna
MONSTER:('L',"Vecna"),(28,06)
TERRAIN:(28,06),'\'

# Random monsters
MONSTER:'Z',random
MONSTER:'Z',random
MONSTER:'Z',random
MONSTER:'Z',random
MONSTER:'M',random
MONSTER:'M',random
MONSTER:'M',random
MONSTER:'M',random
MONSTER:'V',random
MONSTER:'V',random
MONSTER:'&',random
MONSTER:'&',random
MONSTER:' ',random
MONSTER:' ',random
MONSTER:('Z',"revenant"),random
MONSTER:('Z',"revenant"),random
MONSTER:('Z',"revenant"),random
MONSTER:('Z',"revenant"),random
MONSTER:('Z',"revenant"),random
MONSTER:('Z',"revenant"),random
MONSTER:('Z',"revenant"),random
MONSTER:('Z',"revenant"),random
MONSTER:('Z',"revenant"),random
MONSTER:('Z',"revenant"),random
MONSTER:('Z',"revenant"),random
MONSTER:('Z',"revenant"),random
MONSTER:('e',"beholder"),random
MONSTER:('L',"lich"),random
MONSTER:('L',"lich"),random
MONSTER:('L',"lich"),random
MONSTER:('L',"lich"),random
MONSTER:('L',"demilich"),random
MONSTER:('L',"demilich"),random
IF [35%] {
  MONSTER:('h',"alhoon"),random
}

# Vecna's loot
CONTAINER:('(',"crystal chest"),(27,06) {
  IF [20%] {
    OBJECT:('(',"magic marker"),uncursed
  }
  OBJECT:'$',quantity:20000
  OBJECT:'*',uncursed
  OBJECT:'*',uncursed
  OBJECT:'*',uncursed
  OBJECT:'*',uncursed
  OBJECT:'?',uncursed
  OBJECT:'?',uncursed
  OBJECT:'?',blessed
  OBJECT:'=',cursed
  OBJECT:'=',blessed
  OBJECT:'=',uncursed
  OBJECT:'"',uncursed
  OBJECT:'"',blessed
  OBJECT:'!',cursed
  OBJECT:'!',blessed
  OBJECT:'+',uncursed
  OBJECT:'+',uncursed
  OBJECT:'+',uncursed
  OBJECT:'+',cursed
  OBJECT:'+',blessed
}

# More loot
OBJECT:('(',"iron safe"),(08,06)
OBJECT:('(',"chest"),(09,06)
OBJECT:('(',"chest"),(09,07)

# Bodies of past adventurers
OBJECT:('%',"corpse"),random,montype:"archeologist"
OBJECT:('%',"corpse"),random,montype:"barbarian"
OBJECT:('%',"corpse"),random,montype:"caveman"
OBJECT:('%',"corpse"),random,montype:"convict"
OBJECT:('%',"corpse"),random,montype:"healer"
OBJECT:('%',"corpse"),random,montype:"infidel"
OBJECT:('%',"corpse"),random,montype:"knight"
OBJECT:('%',"corpse"),random,montype:"ranger"
OBJECT:('%',"corpse"),random,montype:"rogue"
OBJECT:('%',"corpse"),random,montype:"priestess"
OBJECT:('%',"corpse"),random,montype:"samurai"
OBJECT:('%',"corpse"),random,montype:"tourist"
OBJECT:('%',"corpse"),random,montype:"valkyrie"
OBJECT:('%',"corpse"),random,montype:"wizard"

# Random objects
OBJECT:random,random
OBJECT:random,random
OBJECT:random,random
OBJECT:random,random
OBJECT:random,random
OBJECT:random,random
OBJECT:random,random
OBJECT:random,random
OBJECT:(')',"axe"),random

# Random traps
TRAP:"ice",random
TRAP:"ice",random
TRAP:random, random
TRAP:random, random
TRAP:random, random
TRAP:random, random
TRAP:random, random
TRAP:random, random
TRAP:random, random
TRAP:random, random
TRAP:random, random
TRAP:random, random
TRAP:random, random
TRAP:random, random

# None shall pass
NON_DIGGABLE:(01,01,35,15)
NON_DIGGABLE:(56,11,61,15)
NON_PASSWALL:(00,00,75,20)

